-1 -1 -1 -1 -1 -1 -1 -1 -1 -1 -1 -1 -1 -1 -1 -1 -1 -1 -1 -1 -1 50 51 52 -1 1
-1 -1 -1 -1 -1 -1 50 51 52 -1 -1 -1 -1 -1 -1 -1 -1 -1 -1 -1 -1 -1 -1 -1 63 1
-1 -1 -1 -1 -1 -1 -1 -1 -1 -1 -1 -1 -1 -1 -1 -1 -1 -1 -1 -1 -1 -1 -1 -1 64 1
77 77 77 77 77 77 77 77 77 77 77 77 77 -1 -1 -1 -1 -1 -1 -1 -1 -1 -1 -1 64 1
-1 -1 -1 -1 -1 -1 -1 -1 -1 -1 -1 -1 -1 -1 -1 -1 -1 -1 -1 -1 -1 -1 -1 -1 64 1
-1 -1 -1 -1 -1 -1 -1 -1 -1 -1 -1 -1 -1 -1 -1 -1 -1 -1 -1 -1 -1 -1 -1 63 64 1
63 -1 -1 -1 -1 -1 -1 -1 -1 -1 -1 -1 -1 -1 -1 -1 -1 -1 -1 -1 -1 -1 -1 64 64 1
64 -1 -1 -1 -1 -1 -1 -1 -1 -1 -1 -1 89 89 89 89 89 89 89 89 89 -1 -1 64 64 1
64 -1 -1 -1 -1 -1 -1 -1 -1 -1 -1 -1 -1 -1 -1 -1 -1 -1 -1 -1 -1 -1 -1 64 64 1
64 -1 -1 57 -1 -1 -1 -1 -1 -1 -1 -1 -1 -1 -1 -1 -1 57 57 -1 -1 -1 -1 64 64 1
 4  4  4  4  4  4  4  4  4  4  4  4  4  5 -1 -1  3  4  4  4  4  4  4  4  4 1
10 10 10 10 10 10 10 10 10 10 10 10 10 11 -1 -1  9 10 10 10 10 10 10 10 10 1
10 10 10 10 10 10 10 10 10 10 10 10 10 11 -1 -1  9 10 10 10 10 10 10 10 10 1
10 10 10 10 10 10 10 10 10 10 10 10 10 11 -1 -1  9 10 10 10 10 10 10 10 10 1
 0  1  1  1  1  1  1  1  1  1  2  0  1  1  1  1  1  1  1  1  1  1  1  1  1 1